###########
#..#.....#.
#.##.....#.
#..######..
#..#####..#
#..#...#..#
#..#...#..#
#.######..#
###....##.#
#....@....#
###########