...........
...#.....#.
..##.....#.
...######..
...#####...
...#...#...
...#...#...
...........
..#......#.
.###.@..###
..#......#.