...###
..##.#.####
.##..###..#
##........#
....@..#...
###..###..#
..#..#....#
.##.##.#.##
..........
.#.....##
.#######