.#......#.
...#.##...
..##..##..
...##.#...
...#..#...
...#.##...
..##..##..
...##@#...
...#..#...
...#.##...
.#......#.