##########
#..#.##..#
#.##..##.#
#..##.#..#
##.#..#.##
#..#.##..#
#.##..##.#
#..##@#..#
##.#..#.##
#..#.##..#
##......##