##########
#......@.#
##.#######
#........#
#####.####
#........#
#######.##
#........#
########.#
#........#
##########