#####.#.##
.......@..
##.#######
..........
#####.####
..........
#######.##
..........
########.#
..........
#####.#.##