##.########
#.#.#..#..#
#.#.##...##
#.........#
######.#.##
#.#.#..#..#
###...###.#
#.#.@..#..#
###.#..#.##
#.####.#..#
##....#####