#...#..#...
.#...#.##..
..#....#..#
#..##....##
#...##....#
###...#..#.
.#....#..#.
.#..##..#..
.#........#
###@#.#.#.#
###########
