##.###.###.
#.#.#..#...
#.#.##...#.
#......#...
######.#.#.
#.#.#..#...
###...###..
#.#.@..#...
###.#..#.#.
#.####.#...
##.....###.