####..####
#........#
#.######.#
#.#....#.#
#.#.##.#.#
#.#.#@.#.#
#.#.####.#
#.#......#
#.########
#........#
..........